Margherita Napoli - SALERNO - Automata theory, Formal language theory
Giuseppe De Giacomo - ROME - KR, DL (INVITED SPEAKER)
Giorgio Delzanno - GENOVA - Verification of distributed/MAS/parameterised systems (also a little application side)
Massimo Bartoletti - CAGLIARI -  
Bilo - SALENTO/LECCE - Game Theory, Comp Complexity, optimisation on networks (previous chair)
Stefania Costantini - L'Aquila -  program semantics, AI, logic programming
Pierpaolo Degano - PISA - static analysis
Massimo Franceschet - UDINE - AI
Alessio Lomuscio - IMPERIAL - MAS, MC
Fabio Patrizi - ROME
Luca Pulina - Sassari - SARDINIA - QBF, DL, ML
Gianluca Pozzato - TORINO - DL
Fabrizio Riguzzi - AI
Francesca Rossi - PADOVA -  AI
Guido Sciavicco - FERRARA
Umberto Grandi - Tolouse
Laura Giordano - PIEMONTE ORIENTALE - DL
Jeremy Sproston - TORINO - timed systems, probabilistic systems, verification
Giuseppe Perelli - Oxford - UK
Marco Maratea - GENOVA - ASP, ontologies
Rocco de Nicola - LUCCA - 
Alberto Pettorossi - ROMA - formal methods
Raffaella Gentilini - PERUGIA - games, automata, synthesis
Giuseppe Italiano - ROME - algorithms on graphs, big data, security
Eugenio Omodeo - TRIESTE - 
Marco Manna - CALABRIA - logic programming and DB
Manuela Montangero - MODENA Reggio Emilia - ML: twitter, metapredictor, bioinformatics, motif discovery- 
Gianbattista Ianni - CALABRIA - ASP
Salvatore Latorre - SALERNO
Barbara Massucci - SALERNO
Ugo Del Lago
Fernando Fioretto - MICHIGAN - 
Serena Villata - INRIA - KR, argumentation, semantics, MAS, 
Davide Ancona - GENOVA - 
Luca Bortolussi - TRIESTE
Fabio Fioravanti - CHIETI PESCARA
Paolo Baldan - PADUA
Guido Boella - Torino - Argumentation
Enrico Nardelli - ROMA - Bioinformatics, Information systems, Algorithms, Databases
Adriano Peron 
Ezio Bartocci - VIENNA - run time verification
Formisano - PERUGIA - 
Luca Aceto - Rekjavik - 
Ferilli (Bari)
Mello (Ferrara)
Carla Piazza (Udine)
Montali (Bolzano) 
Sala (Verona)
Mascardi (Genova)
Gianfranco Rossi (Parma)
Ferrari (Milano)
Maubert (Napoli)
Mateo Mio (France)
Tiziano Villa - VERONA - Hybrid systems (verification and synthesis)
Mogavero Fabio
